R 1920 1080
NO ../pics/redbrick.png
SO ../pics/colorstone.png
WE ../pics/colorstone.png
EA ../pics/purplestone.png
S ../pics/barrel.png

F 116,102,59
C 63,91,132

1 1 1 1 1 1 1 1 1 1 1 1 1 1 1 1 1 1 1 1 1 1 1 1 1 1 1 1 1
1 0 0 0 0 0 0 0 0 0 1 1 0 0 0 0 0 0 0 0 0 0 0 0 0 0 0 0 1
1 0 1 1 0 0 0 0 0 1 1 1 0 0 0 0 2 2 2 2 2 2 2 0 0 0 0 0 1
1 0 0 1 0 0 2 0 0 0 0 0 0 0 S 0 0 2 2 2 2 2 2 0 0 0 0 0 1
1 0 1 1 0 0 0 0 0 1 1 1 0 0 0 0 2 2 2 2 2 2 2 0 0 0 0 0 1
1 0 0 0 0 0 0 0 0 0 1 1 0 0 0 0 0 1 1 1 0 1 1 1 1 1 1 1 1
1 0 1 1 0 1 1 1 1 1 1 1 1 1 0 1 1 1 0 0 0 0 2 2 2 0 0 0 1
1 0 1 1 0 1 1 1 1 1 1 1 1 1 0 1 1 1 0 1 0 1 1 1 1 0 0 0 1
1 0 0 0 0 0 0 0 1 1 0 1 0 1 0 1 1 1 0 0 0 0 1 1 1 0 0 0 1
1 0 0 0 2 0 0 0 0 0 0 0 0 0 0 0 1 1 0 0 0 0 1 1 1 0 0 0 1
1 0 0 0 0 0 0 0 0 0 0 0 0 0 0 0 1 1 0 1 0 1 1 0 1 0 0 0 1
1 0 0 0 0 0 0 0 1 1 0 1 0 1 0 1 1 1 1 1 0 1 1 0 1 0 0 0 1
1 0 1 1 0 1 1 1 1 1 1 1 0 1 0 1 1 1 1 1 0 1 1 0 1 0 0 0 1
1 0 1 1 1 1 1 1 1 1 1 1 1 1 1 1 1 1 1 1 1 1 1 0 1 1 1 1 1
1 0 1
1 0 1
1 0 1
1 1 1