R 1920 1080
NO ./pics/redbrick.png
SO ./pics/colorstone.png
WE ./pics/bluestone.png
EA ./pics/purplestone.png
S ./pics/barrel.png

F 116,102,59
C 63,91,132


        111111111111111111111
        100000000000000002001
        100000000000000000001
11111111100000S00002002002001
10110000000100000000000000001
10000000001100000111011111111
10110111111111011100000000001
1011011111111101 101011110001
10000000110101211100001110201
10002000000000000100001110001
10000000002000001101011010021
10000000110101011111011010001
1011011111110101  11011010001
11111111111111111111111011111